WWWWWWWWWWWWWWWWWWWWWWWWWWWWWWWWWWWWWWWW
W--------------------------------------W
W--------------------------------------W
W--------------------------------------W
W--------------------------------------W
W--------------------------------------W
W--------------------------------------W
W--------------WWWWWWWWW---------------W
W--------------W--BP---W---------------W
W--------------W--W-W--W---------------W
W--------------WX-W-W-IW---------------W
W--------------WWWWSWWWW---------------W
W--------------W-E-----W---------------W
W--------------WWWWSWWWW---------------W
W-----------------W-W------------------W
W-----------------WGW------------------W
W-----------------WWW------------------W
W--------------------------------------W
W--------------------------------------W
W--------------------------------------W
W--------------------------------------W
W--------------------------------------W
WWWWWWWWWWWWWWWWWWWWWWWWWWWWWWWWWWWWWWWW