WWWWWWWWWWWWWWWWWWWWWWWWWWWWWWWWWWWWWWWW
W--------------------------------------W
W--------------------------------------W
W--------------------------------------W
W--------------------------------------W
W---------WWW--WWW-----WWW--WWW--------W
W---------WPW-WW-W-----WPW--W-W--------W
W---------W-W-WE-W-----W-W-WW-W--------W
W---------W-W-WW-W-----W-W-WE-W--------W
W---------W-WWWW-WWWW--W-WWWW-WWWW-----W
W---------W--------GW--W--------GW-----W
W---------W-WWWW-WWWW--W-WWWW-WWWW-----W
W---------W-W--WWW-----W-W--WWW--------W
W---------W-W----------W-W-------------W
W---------W-W----------W-W-------------W
W---------WXW----------WXW-------------W
W---------WWW----------WWW-------------W
W--------------------------------------W
W--------------------------------------W
W--------------------------------------W
W--------------------------------------W
W--------------------------------------W
WWWWWWWWWWWWWWWWWWWWWWWWWWWWWWWWWWWWWWWW