WWWWWWWWWWWWWWWWWWWWWWWWWWWWWWWWWWWWWWWW
W--------------------------------------W
W--------------------------------------W
W--------------------------------------W
W--------------------------------------W
W--------------------------------------W
W----------WWWWWW----------------------W
W----------WX---W----------------------W
W----------W----WW---------------------W
W----------W---TTWW--------------------W
W--------WWWWWBWWTW--------------------W
W----WWWWW-W-----WW--------------------W
W----WGG-W-W-DDD-TWW-------------------W
W----WII-S-S-DPD-TTW-------------------W
W----WGG-W-W-DDD-WTW-------------------W
W----WWWWW-W-----WGW-------------------W
W-------WE-WWWBTWW-W-------------------W
W-------WWWW-WTW---W-------------------W
W------------WTWBWWW-------------------W
W------------WTTTW---------------------W
W------------WWWWW---------------------W
W--------------------------------------W
WWWWWWWWWWWWWWWWWWWWWWWWWWWWWWWWWWWWWWWW