WWWWWWWWWWWWWWWWWWWWWWWWWWWWWWWWWWWWWWWW
W--------------------------------------W
W--------------------------------------W
W--------------------------------------W
W--------------------------------------W
W--------------------------------------W
W--------------------------------------W
W--------------------------------------W
W--------------W-----------------------W
W-------------WXW----------------------W
W-------------WBW----------------------W
W------------WT-TW---------------------W
W-----------WT-I-TW--------------------W
W-----------WT-P-TW--------------------W
W-----------WT---TW--------------------W
W------------WT-TW---------------------W
W-------------WTW----------------------W
W--------------W-----------------------W
W--------------------------------------W
W--------------------------------------W
W--------------------------------------W
W--------------------------------------W
WWWWWWWWWWWWWWWWWWWWWWWWWWWWWWWWWWWWWWWW