WWWWWWWWWWWWWWWWWWWWWWWWWWWWWWWWWWWWWWWW
W--------------------------------------W
W----WWWWWWWWWWWWWWWWWWWWWWWW----------W
W----WP--WG-----------GBW--XW----------W
W----W---W--E-----------W---W----------W
W----W---W----G-B-------W---W----------W
W----W---W---E------E---W---W----------W
W----W---WB----------G--W---W----------W
W----W---W------B------BW---W----------W
W----W---W-----G--E-----W---W----------W
W----W---W--------------W---W----------W
W----W---W------B-------W---W----------W
W----W---WB-------------W---W----------W
W----W---WTTTTTTTTTTTTTTT---W----------W
W----W---II-----------------W----------W
W----W----------------------W----------W
W----WWWWWWWWWWWWWWWWWWWWWWWW----------W
W--------------------------------------W
W--------------------------------------W
W--------------------------------------W
W--------------------------------------W
W--------------------------------------W
WWWWWWWWWWWWWWWWWWWWWWWWWWWWWWWWWWWWWWWW