WWWWWWWWWWWWWWWWWWWWWWWWWWWWWWWWWWWWWWWW
W--------------------------------------W
W--------------------------------------W
W-------WWWWWWWWWWWWWWWWWWWW-----------W
W-------WPI--WIW------WIIWGW-----------W
W-------W----WIW------W--WBW-----------W
W-------W-----B--------BWWBW-----------W
W-------W----------------WBW-----------W
W-------W--------WWWWB---WBW-----------W
W-------W--------WII--W--WBW-----------W
W-------WWBW-----WWWWW-----W-----------W
W-------WWBW---------------W-----------W
W-------WWBW-----WBW-------W-----------W
W-------WWBW-----WBW-------W-----------W
W-------WWBW-----WBW-------W-----------W
W-------W-BWWWWW-WBW--WWWWWW-----------W
W-------WX-IIIIIBBBW--BBIIIW-----------W
W-------WWWWWWWWWWWWWWWWWWWW-----------W
W--------------------------------------W
W--------------------------------------W
W--------------------------------------W
W--------------------------------------W
WWWWWWWWWWWWWWWWWWWWWWWWWWWWWWWWWWWWWWWW