WWWWWWWWWWWWWWWWWWWWWWWWWWWWWWWWWWWWWWWW
W--------------------------------------W
W--------------------------------------W
W--------------------------------------W
W----WWWWWWWWWWWWWWWWWWWWWW------------W
W----W---------X----------W------------W
W----W--------------------W------------W
W----W----TTTTT-TTTTT-----W------------W
W----W----T---TTT---T-----W------------W
W----W----T-G-TBT-G-T-----W------------W
W----W----T---T-T---T-----W------------W
W----W----TTTTTITTTTT-----W------------W
W----W-----TB--P--BT------W------------W
W----W----TTTTT-TTTTT-----W------------W
W----W----T---T-T---T-----W------------W
W----W----T-G-TBT-G-T-----W------------W
W----W----T---TTT---T-----W------------W
W----W----TTTTT-TTTTT-----W------------W
W----W--------------------W------------W
W----W--------------------W------------W
W----WWWWWWWWWWWWWWWWWWWWWW------------W
W--------------------------------------W
WWWWWWWWWWWWWWWWWWWWWWWWWWWWWWWWWWWWWWWW